VVVVVVVVVVVVVVVVVVVVVVVVVVWWWWWWWWVVVVVVVVVVVVVVVV
VVVVVVVVVVVVVVVVVVVVVVVVVWW   M  WWVVVVVVVVVVVVVVV
VVVVVVVVVVVVVVVVVVVVVVVVVW  WWM  SWVVVVVVVVVVVVVVV
VVVVVVVVVVVVVVVVVVVVVVVVWW   WW   WWWVVVVVVVVVVVVV
VVVVVVVVVVVVVVWWWWWWWWWVW           WVVVVVVVVVVVVV
VVVVVVVVVVVVVVWCM     WWW33WWWWWW   WVVVVVVVVVVVVV
VVVVVVVVVVVVVVWWWW     WR SWVVVVW   WVVVVVVVVVVVVV
VVVVVVVVVVVVVVVVWM         WVVVVW444WWWWWWWWVVVVVV
VVVVVVVVVVVVVVVVWW  WWWWWWWWVVWWW    M     WVVVVVV
VVVVVVVVVVVVVWWWWW22WWVVVVVVVVW        WW  WVVVVVV
VVVVVVVWWWWWWW       WWVVVVVVVWm  WW   MM  WVVVVVV
VVVVVVVWC  WWR   WS   WVVVVVVVWWWWWW    SWWWVVVVVV
VVVVVVVW   WW    WM   WVVVVVWWWWWWWWWW555WMWVVVVVV
VVVVWWWW   WW    WW   WVVVVVW              WWWWWWV
VVVVWM  M      M      WVVVVVW   WWWW   WW     M WV
VVVVWWW    WWWWWWWWWWWWVVVVVW  Rm      MM  WWWW6WV
VVVVVVW   s WVVVVVVVVVVVVVVVWWWWWWWW  R S  WVVW WV
VVWWWWWWWW11WVVVVVVVVVVVVVVVVVVVVVVWWWWWWWWWWWW WV
VVW      1  WVVVVVVVVWWWWWWWWVVVVVVVVVVWW       WV
VVWP  S  1  WWVVVVVVVW      WWWWWWWVVVVW  WW    WV
VVW      1   WWVWWWWVW           RWVVVVW  M    WWV
WWWWWWWWWWWWWWWWW mWWW      WWMM  WVVVVWW     WWWV
W             9      9   B  WW   CWVWWWWWWW    RWV
W             9 M    9      WWWWWWWVWCR         WV
WW           WWWWC WWW      WVVVVVVVW77WWWWWWW  WV
VWW         WWVVWWWWVW      WVVVVVVVW  WVVWS    WV
VVW         WVVVVVVVVWW  WWWWVVVVVWWW  WVVWWWWWWWV
VVWWWWW99WWWWVVVVVVVVVW99WWWWVVVVVW    WWVVVVVVVVV
VVVVVVWmMWVVVVVVVVVVWWW  RR WWWVVVWWW  MWVVVVVVVVV
VVVVVVWWWWVVVVVVVVVVW    WW   WWWWWWW  WWWVVVVVVVV
VVVVVVVVVVVVVVVVVVVVWWM          RWWW  SMWVVVVVVVV
VVVVVVVVVVVVVVVVVVVVVWWWW CWWMW     W88WWWVVVVVVVV
VVVVVVVVVVVVVVVVVVVVVVVVWWWWWWWW       WVVVVVVVVVV
VVVVVVVVVVVVVVVVVVVVVVVVVVVVVVVW     WWWVVVVVVVVVV
VVVVVVVVVVVVVVVVVVVVVVVVVVVVVVVWWW  MWWVVVVVVVVVVV
VVVVVVVVVVVVVVVVVVVVVVVVVVVVVVVWS     WVVVVVVVVVVV
VVVVVVVVVVVVVVVVVVVVVVVVVVVVVVVWWWWWWWWVVVVVVVVVVV